   text	   data	    bss	    dec	    hex	filename
    188	     10	      8	    206	     ce	sdds.co
    392	      0	      0	    392	    188	objs-128rfa1/alpha-ds.o
    324	      0	      0	    324	    144	objs-128rfa1/atmega_sdds_impl.o
    391	      0	      0	    391	    187	objs-128rfa1/beta-ds.o
   3527	      0	     24	   3551	    ddf	objs-128rfa1/sdds-BuiltinTopic.o
   1402	      2	     46	   1450	    5aa	objs-128rfa1/sdds-DataSink.o
   1443	      2	     76	   1521	    5f1	objs-128rfa1/sdds-DataSource.o
     88	      0	      0	     88	     58	objs-128rfa1/sdds-Debug.o
   1292	      0	    206	   1498	    5da	objs-128rfa1/sdds-Discovery.o
    350	      0	      0	    350	    15e	objs-128rfa1/sdds-Locator.o
    502	      0	     41	    543	    21f	objs-128rfa1/sdds-LocatorDB.o
      0	      0	      0	      0	      0	objs-128rfa1/sdds-Management.o
    524	      0	      0	    524	    20c	objs-128rfa1/sdds-Marshalling.o
    174	      0	      0	    174	     ae	objs-128rfa1/sdds-Msg.o
     94	      0	      0	     94	     5e	objs-128rfa1/sdds-NetBuffRef.o
   2327	      0	      0	   2327	    917	objs-128rfa1/sdds-SNPS.o
    186	      0	      0	    186	     ba	objs-128rfa1/sdds-Topic.o
    392	      0	    157	    549	    225	objs-128rfa1/sdds-TopicDB.o
    501	      0	      2	    503	    1f7	objs-128rfa1/sdds-contiki-Log.o
     12	      0	      0	     12	      c	objs-128rfa1/sdds-contiki-Memory.o
    227	      0	      0	    227	     e3	objs-128rfa1/sdds-contiki-NodeConfig.o
    473	     10	     10	    493	    1ed	objs-128rfa1/sdds-contiki-Task.o
   1889	      0	     13	   1902	    76e	objs-128rfa1/sdds-contiki-UDP.o
      0	      0	      0	      0	      0	objs-128rfa1/sdds-sDDS.o
   1088	      0	    176	   1264	    4f0	obj_avr-atmega128rfa1/aes-128.o
    252	      0	      4	    256	    100	obj_avr-atmega128rfa1/anti-replay.o
     44	      0	    129	    173	     ad	obj_avr-atmega128rfa1/arg.o
     71	      0	      0	     71	     47	obj_avr-atmega128rfa1/assert.o
     56	      0	      0	     56	     38	obj_avr-atmega128rfa1/autostart.o
    244	      0	      4	    248	     f8	obj_avr-atmega128rfa1/bootloader.o
     59	      0	      0	     59	     3b	obj_avr-atmega128rfa1/button-sensor.o
    362	      0	      0	    362	    16a	obj_avr-atmega128rfa1/ccm-star-packetbuf.o
    674	      0	      0	    674	    2a2	obj_avr-atmega128rfa1/ccm-star.o
    630	      0	      3	    633	    279	obj_avr-atmega128rfa1/clock.o
    376	      0	      8	    384	    180	obj_avr-atmega128rfa1/compower.o
   1822	      3	      0	   1825	    721	obj_avr-atmega128rfa1/contiki-main.o
    288	      0	      0	    288	    120	obj_avr-atmega128rfa1/contikimac-framer.o
   2135	      0	     42	   2177	    881	obj_avr-atmega128rfa1/contikimac.o
    116	      0	      0	    116	     74	obj_avr-atmega128rfa1/crc16.o
   1197	     24	    177	   1398	    576	obj_avr-atmega128rfa1/csma.o
    587	     10	      3	    600	    258	obj_avr-atmega128rfa1/ctimer.o
   2144	      0	     97	   2241	    8c1	obj_avr-atmega128rfa1/dhcpc.o
     28	      0	      0	     28	     1c	obj_avr-atmega128rfa1/eeprom.o
    518	      0	      6	    524	    20c	obj_avr-atmega128rfa1/elfloader-avr.o
   3179	      0	     20	   3199	    c7f	obj_avr-atmega128rfa1/elfloader.o
    276	      0	      0	    276	    114	obj_avr-atmega128rfa1/energest.o
    728	     10	      4	    742	    2e6	obj_avr-atmega128rfa1/etimer.o
    172	      0	      0	    172	     ac	obj_avr-atmega128rfa1/flash.o
   1052	      0	      0	   1052	    41c	obj_avr-atmega128rfa1/frame802154.o
    568	      0	      2	    570	    23a	obj_avr-atmega128rfa1/framer-802154.o
    134	      0	      0	    134	     86	obj_avr-atmega128rfa1/framer-nullmac.o
     52	      0	      0	     52	     34	obj_avr-atmega128rfa1/framer.o
    372	      0	      3	    375	    177	obj_avr-atmega128rfa1/gcr.o
    474	      0	      0	    474	    1da	obj_avr-atmega128rfa1/halbb.o
   1068	      0	      0	   1068	    42c	obj_avr-atmega128rfa1/ifft.o
    214	      0	      0	    214	     d6	obj_avr-atmega128rfa1/ip64-addr.o
      8	      0	      0	      8	      8	obj_avr-atmega128rfa1/leds-arch.o
    568	      0	      1	    569	    239	obj_avr-atmega128rfa1/leds.o
     58	      0	      0	     58	     3a	obj_avr-atmega128rfa1/linkaddr.o
    362	      0	      0	    362	    16a	obj_avr-atmega128rfa1/list.o
    240	      0	    144	    384	    180	obj_avr-atmega128rfa1/mac-sequence.o
     16	      0	      0	     16	     10	obj_avr-atmega128rfa1/mac.o
     74	      0	      0	     74	     4a	obj_avr-atmega128rfa1/me.o
   1024	      0	      0	   1024	    400	obj_avr-atmega128rfa1/me_tabs.o
    318	      0	      0	    318	    13e	obj_avr-atmega128rfa1/memb.o
    256	      0	   4100	   4356	   1104	obj_avr-atmega128rfa1/mmem.o
    136	      0	      2	    138	     8a	obj_avr-atmega128rfa1/mt.o
    300	      0	      4	    304	    130	obj_avr-atmega128rfa1/mtarch.o
   1302	      8	    280	   1590	    636	obj_avr-atmega128rfa1/nbr-table.o
     40	      0	      0	     40	     28	obj_avr-atmega128rfa1/netstack.o
     70	      0	      0	     70	     46	obj_avr-atmega128rfa1/nullmac.o
    112	      0	      0	    112	     70	obj_avr-atmega128rfa1/nullradio.o
    245	      0	      0	    245	     f5	obj_avr-atmega128rfa1/nullrdc-noframer.o
    340	      0	      0	    340	    154	obj_avr-atmega128rfa1/nullrdc.o
     88	      0	      0	     88	     58	obj_avr-atmega128rfa1/nullsec.o
    770	      0	    183	    953	    3b9	obj_avr-atmega128rfa1/packetbuf.o
    461	     41	      0	    502	    1f6	obj_avr-atmega128rfa1/params.o
    242	      0	      0	    242	     f2	obj_avr-atmega128rfa1/petsciiconv.o
    584	     16	    340	    940	    3ac	obj_avr-atmega128rfa1/phase.o
    559	      0	      0	    559	    22f	obj_avr-atmega128rfa1/print-stats.o
    840	      0	    176	   1016	    3f8	obj_avr-atmega128rfa1/process.o
     32	      0	      0	     32	     20	obj_avr-atmega128rfa1/procinit.o
   1070	      0	      0	   1070	    42e	obj_avr-atmega128rfa1/psock.o
    422	     16	   1440	   1878	    756	obj_avr-atmega128rfa1/queuebuf.o
      8	      0	      0	      8	      8	obj_avr-atmega128rfa1/random.o
   4245	     20	    375	   4640	   1220	obj_avr-atmega128rfa1/resolv.o
   2731	     10	    131	   2872	    b38	obj_avr-atmega128rfa1/rf230bb.o
    168	      0	      0	    168	     a8	obj_avr-atmega128rfa1/ringbuf.o
   4610	      6	    986	   5602	   15e2	obj_avr-atmega128rfa1/roll-tm.o
    949	      0	     38	    987	    3db	obj_avr-atmega128rfa1/rpl-dag-root.o
   6040	     10	    200	   6250	   186a	obj_avr-atmega128rfa1/rpl-dag.o
   1024	      0	      0	   1024	    400	obj_avr-atmega128rfa1/rpl-ext-header.o
   3256	     25	      0	   3281	    cd1	obj_avr-atmega128rfa1/rpl-icmp6.o
    496	     14	      0	    510	    1fe	obj_avr-atmega128rfa1/rpl-mrhof.o
    360	     14	      0	    374	    176	obj_avr-atmega128rfa1/rpl-of0.o
   1314	      0	     19	   1333	    535	obj_avr-atmega128rfa1/rpl-timers.o
    834	      0	      2	    836	    344	obj_avr-atmega128rfa1/rpl.o
    440	     14	      1	    455	    1c7	obj_avr-atmega128rfa1/rs232.o
    720	      0	      0	    720	    2d0	obj_avr-atmega128rfa1/rtimer-arch.o
    120	      0	      2	    122	     7a	obj_avr-atmega128rfa1/rtimer.o
    568	     10	      5	    583	    247	obj_avr-atmega128rfa1/sensors.o
    320	     10	    264	    594	    252	obj_avr-atmega128rfa1/serial-line.o
      0	      0	      0	      0	      0	obj_avr-atmega128rfa1/settings.o
    657	      0	      1	    658	    292	obj_avr-atmega128rfa1/sicslowmac.o
   4791	      0	    166	   4957	   135d	obj_avr-atmega128rfa1/sicslowpan.o
    547	     10	    129	    686	    2ae	obj_avr-atmega128rfa1/simple-udp.o
    949	     10	    153	   1112	    458	obj_avr-atmega128rfa1/slip.o
     86	     14	      1	    101	     65	obj_avr-atmega128rfa1/slip_uart0.o
    308	      0	   1285	   1593	    639	obj_avr-atmega128rfa1/slipdev.o
    369	      0	    147	    516	    204	obj_avr-atmega128rfa1/smrf.o
    296	      0	      0	    296	    128	obj_avr-atmega128rfa1/stimer.o
     98	      0	      0	     98	     62	obj_avr-atmega128rfa1/symtab-avr.o
   1729	     10	      3	   1742	    6ce	obj_avr-atmega128rfa1/tcp-socket.o
   1869	     10	     33	   1912	    778	obj_avr-atmega128rfa1/tcpip.o
    148	      0	      0	    148	     94	obj_avr-atmega128rfa1/timer.o
    746	      0	      4	    750	    2ee	obj_avr-atmega128rfa1/trickle-timer.o
    631	     10	    129	    770	    302	obj_avr-atmega128rfa1/udp-socket.o
    399	      0	      0	    399	    18f	obj_avr-atmega128rfa1/uip-debug.o
    962	     10	    780	   1752	    6d8	obj_avr-atmega128rfa1/uip-ds6-nbr.o
   1446	     32	    844	   2322	    912	obj_avr-atmega128rfa1/uip-ds6-route.o
   2400	      0	     24	   2424	    978	obj_avr-atmega128rfa1/uip-ds6.o
   1454	     12	     20	   1486	    5ce	obj_avr-atmega128rfa1/uip-icmp6.o
    288	      8	     29	    325	    145	obj_avr-atmega128rfa1/uip-mcast6-route.o
     24	      0	      0	     24	     18	obj_avr-atmega128rfa1/uip-mcast6-stats.o
    178	      0	     20	    198	     c6	obj_avr-atmega128rfa1/uip-nameserver.o
   2046	     12	      9	   2067	    813	obj_avr-atmega128rfa1/uip-nd6.o
    242	      8	   2606	   2856	    b28	obj_avr-atmega128rfa1/uip-packetqueue.o
    244	      0	      0	    244	     f4	obj_avr-atmega128rfa1/uip-split.o
    206	      0	      0	    206	     ce	obj_avr-atmega128rfa1/uip-udp-packet.o
   5854	      0	     13	   5867	   16eb	obj_avr-atmega128rfa1/uip6.o
    422	      0	      0	    422	    1a6	obj_avr-atmega128rfa1/uiplib.o
     96	      0	      0	     96	     60	obj_avr-atmega128rfa1/watchdog.o
